URL : https://lin.uic.edu/people/graduate-students
                         Your browser is unsupported  We recommend using the latest version of IE11, Edge, Chrome, Firefox or Safari.         Skip to the content of this page ,  the main menu , the secondary menu , Google Translate , the site search form , the site home page .               Laboratory of Integrative Neuroscience     Search the site     Toggle Menu      Search                           Laboratory of Integrative Neuroscience      Laboratory of Integrative Neuroscience   Google Translate        Main Menu    People              Faculty    Staff    Post Doctoral Fellows    Graduate Students         Academics              Undergraduate Studies    Graduate Studies    Student Opportunities    Awards         Research              Research Groups    Research Summaries         Seminars    Get Involved              Nu Rho Psi    News    Calendar    Contact Us          Eyebrow menu    las.uic.edu    +Give    UIC menu    UIC.edu    Campus Map       Search                  View Menu              Breadcrumbs   Laboratory of Integrative Neuroscience    People    Graduate Students         Graduate Students      Search Directory by name   Search Button         Filter by          Categories    Graduate Students              Search Results               Abugaber-Bowman,
          David   |  Graduate Student   Psychology    dabuga2@uic.edu               Amoroso,
          Vince   |  Graduate Student   Neuroscience    vamoro1@uic.edu               Applegate,
          Dan   |  Graduate Student   Neuroscience    dapple2@uic.edu               Arzuaga,
          Anna   |  Graduate Student   Biological Sciences    aarzua2@uic.edu               Atteberry,
          Kimberly   |  Graduate Student   Biological Sciences    katteb2@uic.edu               Beeler-Muscat,
          Dina   |  Graduate Student   Biological Sciences    dbeele2@uic.edu               Browe,
          Brigitte   |  Graduate Student   Neuroscience    bbrowe2@uic.edu               Buffington,
          Josh   |  Graduate Student   Psychology    bffngtn2@uic.edu               Cabay,
          Marissa   |  Graduate Student   Neuroscience             Choi,
          Ji-in   |  Graduate Student     jchoi26@uic.edu               Coles,
          Cassandre   |  Graduate Student   Biological Sciences             Conway,
          Sineadh   |  Graduate Student   Psychology    conway5@uic.edu               Corwin,
          Samantha   |  Graduate Student   Psychology    scorwi3@uic.edu               Delaney,
          Taylor   |  Graduate Student   Biological Sciences    tdelan4@uic.edu               Finestrat-MartÃ­nez,
          Irene   |  Graduate Student   Psychology    ifines2@uic.edu               Gallik,
          Kristin   |  Graduate Student   Biological Sciences    kgalli3@uic.edu               Gerth,
          Ashlynn   |  Graduate Student   Psychology    agerth3@uic.edu               Hamada,
          Kana   |  Graduate Student   Neuroscience    khamad2@uic.edu               Heit,
          Bradley   |  Graduate Student   Neuroscience    bheit1@uic.edu               Hilderbrand,
          Elisa   |  Graduate Student   Neuroscience    ehilde2@uic.edu               Jacobs-Brichford,
          Eliza   |  Graduate Student   Psychology    ejacob9@uic.edu               Jeon,
          Sohee   |  Graduate Student   Biological Sciences    sjeon25@uic.edu               Jiang,
          Xinghang   |  Graduate Student   Biological Sciences    xjiang44@uic.edu               Konanur,
          Vaibhav   |  Graduate Student   Psychology    vkonan2@uic.edu               Krout,
          Mia   |  Graduate Student   Biological Sciences    mkrout2@uic.edu               Li,
          Wenping   |  Graduate Student   Biological Sciences    jklwp007@uic.edu               Lombardo,
          Joseph   |  Graduate Student   Neuroscience    jlomba2@uic.edu               Marquez,
          Liliana   |  Graduate Student   Biological Sciences    lmarqu6@uic.edu               McRay,
          Alyssa   |  Graduate Student   Biological Sciences    aray9@uic.edu               Nguyen,
          Mi   |  Graduate Student   Chemistry    tnguy214@uic.edu               Pathmasiri,
          K.P
          Chandimal   |  Graduate Student     kpathm2@uic.edu               Perez,
          Lillian   |  Graduate Student   Biological Sciences    perez36@uic.edu               Pergande,
          Melissa   |  Graduate Student   Chemistry    mperga2@uic.edu               Rajan,
          Sriivatsan
          G.   |  Graduate Student   Biological Sciences    sgovin6@uic.edu               Rodriguez,
          Shelagh   |  Graduate Student   Biological Sciences    smeyer9@uic.edu               Seiler,
          Jillian   |  Graduate Student   Psychology    seiler3@uic.edu               Sheoran,
          Seema   |  Graduate Student   Biological Sciences    ssheor3@uic.edu               Shumov,
          Alina   |  Graduate Student   Neuroscience    ashumo2@uic.edu               Suzuki,
          Nobuko   |  Graduate Student   Biological Sciences    nsuzuk3@uic.edu               Treffy,
          Randall   |  Medical Student   College of Medicine    treffy2@uic.edu               Vice,
          Emily   |  Graduate Student   Neuroscience    evice3@uic.edu               Warrier,
          Vijay   |  Graduate Student   Applied Math & Biological Sciences    vgovind2@uic.edu               Widmer,
          Andrew   |  Graduate Student   Neuroscience    awidme2@uic.edu               Ziang,
          Zhongjiao   |  Graduate Student   Biological Sciences    zjjiang@uic.edu              People              Faculty    Staff    Post Doctoral Fellows    Graduate Students                           College Of  Liberal Arts  And  Sciences         Contact   845 W. Taylor St., 3256 SES Chicago, IL 60607  Phone: (312) 996-2207  lin@uic.edu        Social Media Accounts                  UIC.edu links   UIC.edu  Academic Calendar  Athletics  Campus Directory  Disability Resources  Emergency Information  Event Calendar  Job Openings  Library  Maps  UIC Safe Mobile App  UIC Today  UI Health  Veterans Affairs        Powered by Red 2.38.0  © 2020 The Board of Trustees of the University of Illinois |  Privacy Statement    Campuses   University of Illinois System  Urbana-Champaign  Springfield      Cookie Settings                  