URL : https://lsri.uic.edu/people/everyone
                         Your browser is unsupported  We recommend using the latest version of IE11, Edge, Chrome, Firefox or Safari.         Skip to the content of this page ,  the main menu , the secondary menu , the site search form , the site home page .               Learning Sciences Research Institute     Search the site     Toggle Menu      Search                           Learning Sciences Research Institute      Learning Sciences Research Institute   Main Menu    About              LSRI News    LSRI Events    Visiting LSRI    Work With Us    Contact Us         Projects              Project Stories    Research Projects    Development and Outreach    Past Projects         PhD Program              Course of Study    Applying for a PhD    The Learning Sciences Student Association (LSSA)         People              Everyone    Administration    Faculty    Project Staff    Graduate Students    Alumni    Co-Directors         Collaboration              Funders and Partners    Funding Opportunities    Partner With LSRI         Speaker Series              Spring 2020    Fall 2019    Speaker Series Archive          Eyebrow menu    LSRI Intranet    +Give    UIC menu    UIC.edu    Campus Map       Search                  View Menu              COVID-19   Dear Guests, to prevent the gathering of large crowds amid the current global pandemic, we will be halting any future speaker series and events until further notice. Please check back for updates.        Breadcrumbs   Learning Sciences Research Institute    People    Everyone         Everyone      Search Directory by name   Search Button         Filter by          Categories    Graduate Students     Project Staff     Faculty     Administration     Alumni     Co-Directors     Affiliates              Search Results               Abraham,
          Asha   |  Accounting Aide, Undergraduate Student   Learning Sciences Research Institute    aabrah30@uic.edu               Adach,
          Aleksandra (Ola)   |  Graduate Student   Learning Sciences Research Institute    aadach3@uic.edu               Agosto,
          Joan   |  Research Specialist   Learning Sciences Research Institute    312-413-1606  |  jmagosto@uic.edu               Baker,
          Joanne   |  Senior Program Associate   Learning Sciences Research Institute    jbaker@uic.edu               Becker,
          David   |  Graduate Student   Learning Sciences Research Institute    dbecke4@uic.edu               Bolz,
          Michael
          J.   |  Graduate Student   Learning Sciences Research Institute    mbolz2@uic.edu               Byrne,
          Jenesis   |  Teaching Consultant   Learning Sciences Research Institute    jfield2@uic.edu               Cano,
          Maria   |  Accounting Aide, Undergraduate Student   Learning Sciences Research Institute    mcano3@uic.edu               Cape,
          Elizabeth   |  Teaching Consultant   Learning Sciences Research Institute    ecape@uic.edu               Castro Superfine,
          Alison   |  Professor â Mathematics Education & Learning Sciences   Mathematics, Statistics & Computer Science and Learning Sciences Research Institute    amcastro@uic.edu               Chalmers,
          Jessica   |  Graduate Program Coordinator   Learning Sciences Research Institute    (312) 355-2143  |  jchalmer@uic.edu               Chan,
          Timmy   |  Graduate Student   Learning Sciences Research Institute    tchan30@uic.edu               Cirne-Lima,
          Henrique   |  Multimedia Communications Manager   Learning Sciences Research Institute    (312) 996-2506  |  hcl@uic.edu               Cooper,
          James   |  Graduate Student   Learning Sciences Research Institute    jcoop1@uic.edu               Dasgupta,
          Chandan   |  Alumni              De Voto,
          Craig
          W.   |  Visiting Research Assistant Professor   Learning Sciences Research Institute    cdevot2@uic.edu               Delgado,
          Sandra   |  General Office Aide, Undergraduate Student   Learning Sciences Research Institute    sdelga25@uic.edu               DeSutter,
          Dane   |  Postdoc Research Associate   Learning Sciences Research Institute    ddesut2@uic.edu               Dianovsky,
          Mike   |  Alumni              Duriga,
          Joyce   |  Research Specialist   Learning Sciences Research Institute    jduriga@uic.edu               Espinosa,
          Noemi   |  Budget Analyst/Project Coordinator   Learning Sciences Research Institute    (312) 996-8755  |  nespin1@uic.edu               Fendt,
          Carol   |  Project Director   Learning Sciences Research Institute    cfendt1@uic.edu               Feng,
          Mee Na   |  Graduate Student   Learning Sciences Research Institute    mfeng24@uic.edu               Fry,
          Christopher
          J.   |  Graduate Student   Learning Sciences Research Institute    cfry3@uic.edu               Gane,
          Brian   |  Research Assistant Professor   Learning Sciences Research Institute    (312) 413-0547  |  bgane@uic.edu               Gaur,
          Diksha   |  Graduate Student   Learning Sciences Research Institute    dgaur2@uic.edu               George,
          MariAnne   |  Project Director   Learning Sciences Research Institute    (312) 416-5507  |  georgema@uic.edu               Glover,
          Vanessa   |  Associate Director of Finance and Grants Management   Learning Sciences Research Institute    (312)355-3148  |  vglover@uic.edu               Goldman,
          Susan   |  Co-Director, Learning Sciences Research Institute   Professor, Department of Psychology and Department of Education    (312) 413-1566  |  sgoldman@uic.edu               Hall,
          Allison   |  Visiting Research Specialist   Learning Sciences Research Institute    (312) 413-2383  |  ahall33@uic.edu               Holtz,
          Rachel   |  Graduate Student   Learning Sciences Research Institute    rholtz3@uic.edu               Hospelhorn,
          Emma   |  Alumni              Ibtasar,
          Rabia   |  Graduate Student   Learning Sciences Research Institute    ribtas2@uic.edu               James,
          Katie   |  Alumni              Johnsen,
          Tiana   |  Associate Director of Operations and Human Resources   Learning Sciences Research Institute    (312) 413-9826  |  tiana@uic.edu               Jorion,
          Natalie   |  Alumni              Kaduk,
          Catherine   |  Graduate Student   Learning Sciences Research Institute    ckaduk2@uic.edu               Kang,
          Raymond   |  Graduate Student   Learning Sciences Research Institute    rkang2@uic.edu               Ko,
          Monica   |  Research Assistant Professor   Learning Sciences Research Institute    (312) 413-2383  |  mlko@uic.edu               Krzak,
          Andrew   |  Information Technology Manager   Learning Sciences Research Institute    (312) 355-6515  |  akrzak1@uic.edu               Lawless,
          Kimberly   |  Professor   Educational Psychology    klawless@uic.edu               Lee-Hassan,
          Alexa   |  Graduate Student   Learning Sciences Research Institute    aleeha2@uic.edu               Leimberer,
          Jennifer   |  Senior Program Associate   Learning Sciences Research Institute    (312) 996-6098  |  jleimb1@uic.edu               Levine,
          Debra   |  Administrative Project Coordinator   Learning Sciences Research Institute    (312) 355-1183  |  dlevin6@uic.edu               Li,
          Wenjuan   |  Alumni              Lira,
          Matthew   |  Alumni              Locoh-A,
          Gabriela   |  Graduate Student   Learning Sciences Research Institute    ggroza2@uic.edu               Lopez,
          Ivan   |  Computer Specialist I, Undergraduate Student   Learning Sciences Research Institute    (312) 355-6515  |  ilopez10@uic.edu               Lopez Silva,
          Brenda   |  Research and Development Specialist   Learning Sciences Research Institute    (312) 996-7706  |  brendita@uic.edu               Lynn,
          James   |  Executive Director for High School Development   Learning Sciences Research Institute    (312) 413-1888  |  jlynn@uic.edu               Lyons,
          Leilah   |  Associate Professor   Department of Computer Science    llyons@uic.edu               Madden,
          Krystal   |  Graduate Student   Learning Sciences Research Institute    kmadde4@uic.edu               Melendez,
          Jose   |  Alumni              Michaelis,
          Joseph   |  Assistant Professor   Department of Computer Science    jmich@uic.edu               Moher,
          Tom   |  Associate Professor Emeritus   Department of Computer Science    moher@uic.edu               Moore,
          Monika   |  Graduate Student   Learning Sciences Research Institute    mmoore49@uic.edu               Mozen,
          Lauren   |  General Office Aide, Undergraduate Student   Learning Sciences Research Institute    lmozen2@uic.edu               Nighelli,
          Teresa   |  Visiting Research Specialist   Learning Sciences Research Institute    312-413-1698  |  nighelli@uic.edu               Pellegrino,
          James   |  Co-Director, Learning Sciences Research Institute   Professor, Department of Psychology and Department of Education    (312) 413-2320  |  pellegjw@uic.edu               Pitvorec,
          Kathleen   |  Research Assistant Professor   Learning Sciences Research Institute    (312) 413-2466  |  kapitvor@uic.edu               Pligge,
          Margie   |  Visiting Senior Program Associate   Learning Sciences Research Institute    (312) 413-1606  |  mpligge@uic.edu               Popp,
          Jacqueline   |  Alumni              Pradeepkumar,
          Prakrithy   |  Graduate Student   Learning Sciences Research Institute    pprade3@uic.edu               Prudent,
          Mirlanda   |  Graduate Student   Learning Sciences Research Institute    mprude2@uic.edu               Puente,
          Enrique   |  Office Support Specialist   Learning Sciences Research Institute    epuent1@uic.edu               Radinsky,
          Josh   |  Associate Professor   Curriculum and Instruction    (312) 413-0326  |  joshuar@uic.edu               Ricketts,
          Amy   |  Postdoc Research Associate   Learning Sciences Research Institute    arr@uic.edu               Roberts,
          Jessica   |  Alumni              Ryan,
          Stephanie   |  Alumni              Ryu,
          Minjung   |  Assistant Professor   Department of Chemistry    312-413-2332  |  mjryu@uic.edu               Schroeder,
          Lianne   |  Alumni              Sedgwick,
          Marrok   |  Graduate Student   Learning Sciences Research Institute    msedgw2@uic.edu               Shah,
          Kushani   |  General Office Aide, Undergraduate Student   Learning Sciences Research Institute    kshah94@uic.edu               Siciliano,
          Lisa   |  Graduate Student   Learning Sciences Research Institute    lsicil2@uic.edu               Slattery,
          Brian   |  Graduate Student   Learning Sciences Research Institute    bslatt2@uic.edu               Slaughter,
          Regeta   |  Visiting Program Associate   Learning Sciences Research Institute    regetas@uic.edu               Snow,
          Melanie   |  Graduate Student   Learning Sciences Research Institute    mjsnow@uic.edu               Stieff,
          Mike   |  Professor   Department of Chemistry    (312) 413-1304  |  mstieff@uic.edu               Stoelinga,
          Timothy   |  Senior Program Associate   Learning Sciences Research Institute    (312) 413-1888  |  stoe@uic.edu               Stout,
          William   |  Research Professor   Department of Statistics    (217) 333-6218  |  w-stout1@illinois.edu               Sutow-Goldrich,
          Jean   |  Teaching Consultant   Learning Sciences Research Institute    sutow@uic.edu               Tavormina,
          Mary Jo   |  Project Director   Learning Sciences Research Institute    (312) 413-1733  |  mjtav@uic.edu               Thompson,
          Kathleen   |  Teaching Consultant   Learning Sciences Research Institute    kittyt@uic.edu               Wink,
          Donald
          J.   |  Professor   Department of Chemistry    (312) 413-2332  |  dwink@uic.edu               Yim,
          Rachel
          A.   |  Visiting Research Specialist   Learning Sciences Research Institute    (312) 413-1698  |  ryim@uic.edu               Zaidi,
          Sania   |  Visiting Research Scientist   Learning Sciences Research Institute    (312) 413-1698  |  sania@uic.edu               Zeller,
          Laura   |  Graduate Student   Learning Sciences Research Institute    lzelle2@uic.edu              People              Everyone    Administration    Faculty     Affiliate Faculty      Project Staff    Graduate Students    Alumni    Co-Directors                           College Of  Liberal Arts  And  Sciences         Contact   Learning Sciences Research Institute  1240 W. Harrison St., Suite 1535, Chicago, IL 60607  Phone: (312) 996-2448  Fax: (312) 413-7411  lsri-info@uic.edu        Social Media Accounts                        UIC.edu links   UIC.edu  Academic Calendar  Athletics  Campus Directory  Disability Resources  Emergency Information  Event Calendar  Job Openings  Library  Maps  UIC Safe Mobile App  UIC Today  UI Health  Veterans Affairs        Powered by Red 2.38.0  © 2020 The Board of Trustees of the University of Illinois |  Privacy Statement    Campuses   University of Illinois System  Urbana-Champaign  Springfield      Cookie Settings                  